mmmmmmmmmmmm
mg.........m
m..........m
m.....g....m
m......g...m
m.......g..m
m..r....r..m
m..........m
m.....g....m
m..........m
m...r....r.m
mmmmmmmmmmmm